1

40 22

150 12
8 8 8 8 8 8 8 8 8 8 8 8 8 8 8 8 8 8 8 8 8 8 8 8 8 8 8 8 8 8 8 8 8 8 8 8 8 8 8 8
8 2 2 2 2 2 2 0 2 2 5 2 3 0 2 2 2 2 2 3 2 3 2 2 2 2 2 2 2 0 2 2 2 2 3 2 2 2 2 8
8 2 3 1 3 2 2 2 2 2 2 0 2 2 2 2 2 2 2 2 2 3 5 2 2 3 2 2 2 2 0 2 2 2 2 2 0 2 2 8
8 2 2 2 2 2 2 2 2 2 2 0 2 2 0 2 2 2 2 2 3 2 3 2 2 3 2 2 2 2 2 2 2 2 3 2 2 2 2 8
8 3 2 0 0 2 2 2 2 2 2 2 2 2 3 2 2 2 2 2 2 3 2 2 3 2 2 2 2 3 2 2 2 3 2 2 2 2 2 8
8 3 2 3 3 2 2 2 2 2 2 2 2 2 3 3 2 2 3 2 2 2 2 2 2 2 2 3 2 2 2 2 2 2 3 2 3 0 2 8
8 2 2 2 3 2 2 3 2 2 2 2 2 2 2 2 3 2 2 2 2 2 3 2 0 3 2 2 2 2 2 2 2 2 3 2 3 3 2 8
8 7 7 7 7 7 7 7 7 7 7 7 7 7 7 7 7 7 7 7 7 7 7 7 7 7 7 7 7 7 7 2 2 2 3 2 2 3 2 8
8 2 0 2 2 2 3 2 2 5 2 0 2 2 3 2 3 2 2 2 2 2 2 2 2 2 2 5 2 3 0 2 2 2 2 2 2 3 2 8
8 2 2 5 2 2 2 2 2 3 2 2 2 2 2 0 2 2 2 2 2 2 2 2 3 0 0 3 2 2 5 2 2 2 2 3 2 2 2 8
8 2 2 2 3 2 2 3 2 3 2 2 2 2 2 2 2 2 2 2 2 2 2 2 3 3 2 3 2 2 3 2 2 2 2 2 2 2 2 8
8 2 0 2 2 2 2 2 3 2 2 2 2 2 2 2 2 3 3 0 2 2 2 2 2 2 2 3 2 2 3 2 5 2 2 2 2 0 2 8
8 2 3 2 2 0 2 2 3 2 0 0 2 2 2 2 2 3 2 3 5 2 2 5 2 2 2 2 3 2 2 2 3 2 2 5 2 3 2 8
8 2 5 3 2 2 2 2 2 2 2 2 2 2 2 2 2 2 3 3 3 2 2 3 2 2 2 2 2 2 2 2 5 2 2 2 2 2 3 8
8 2 2 2 2 2 2 2 2 7 7 7 7 7 7 7 7 7 7 7 7 7 7 7 7 7 7 7 7 7 7 7 7 7 7 7 7 7 7 8
8 0 0 2 2 2 2 2 2 2 2 2 0 2 2 2 5 2 2 2 2 3 2 2 2 2 2 3 2 2 2 3 2 2 2 2 2 2 2 8
8 3 0 2 2 2 2 2 2 2 2 2 3 3 2 2 3 2 2 2 2 2 2 2 2 3 2 2 2 2 2 2 3 2 3 0 2 2 9 8
8 2 3 2 2 3 2 2 2 2 2 2 2 2 3 2 2 2 2 2 3 2 0 0 2 2 2 2 5 2 2 2 3 2 3 3 2 2 2 8
8 2 2 2 2 3 5 2 2 0 2 2 2 2 2 2 2 2 3 2 2 2 2 2 2 3 2 3 5 2 2 2 2 2 2 3 2 2 2 8
8 2 2 2 0 2 2 0 2 3 2 2 3 2 3 3 2 2 2 2 2 2 2 2 2 3 2 3 5 2 2 2 2 2 2 3 2 2 3 8
8 2 5 2 2 2 2 3 2 2 2 2 2 0 2 2 2 2 2 2 2 2 2 0 2 3 2 2 3 2 2 2 2 3 2 2 2 3 2 8
8 8 8 8 8 8 8 8 8 8 8 8 8 8 8 8 8 8 8 8 8 8 8 8 8 8 8 8 8 8 8 8 8 8 8 8 8 8 8 8