2

40 22

150 08
08 08 08 08 08 08 08 08 08 08 08 08 08 08 08 08 08 08 08 08 08 08 08 08 08 08 08 08 08 08 08 08 08 08 08 08 08 08 08 08
08 02 02 02 02 02 02 00 02 02 05 02 03 00 02 02 02 02 02 03 02 03 02 02 02 02 02 02 02 00 02 02 02 02 03 02 02 02 02 08
08 02 03 01 03 02 02 02 02 02 02 00 02 02 02 02 02 02 02 02 02 03 05 02 02 03 02 02 02 02 00 02 02 02 02 02 00 02 02 08
08 02 02 02 02 02 02 02 02 02 02 00 02 02 00 02 02 02 02 02 03 02 03 02 02 03 02 02 02 02 02 02 02 02 03 02 02 02 02 08
08 03 02 00 00 02 02 02 02 02 02 02 02 02 03 02 02 02 02 02 02 03 02 02 03 02 02 02 02 03 02 02 02 03 02 02 02 02 02 08
08 03 02 03 03 02 02 02 02 02 02 02 02 02 03 03 02 02 03 02 02 02 02 02 02 02 02 03 02 02 02 02 02 02 03 02 03 00 02 08
08 02 02 02 03 02 02 03 02 02 02 02 02 02 02 02 03 02 02 02 02 02 03 02 00 03 02 02 02 02 02 02 02 02 03 02 03 03 02 08
08 07 07 07 07 07 07 07 07 07 07 07 07 07 07 07 07 07 07 07 07 07 07 07 07 07 07 07 07 07 07 02 02 02 03 02 02 03 02 08
08 02 00 02 02 02 03 02 02 05 02 00 02 02 03 02 03 02 02 02 02 02 02 02 02 02 02 05 02 03 00 02 02 02 02 02 02 03 02 08
08 02 02 05 02 02 02 02 02 03 02 02 02 02 02 00 02 02 02 02 02 02 02 02 03 00 00 03 02 02 05 02 02 02 02 03 02 02 02 08
08 02 02 02 03 02 02 03 02 03 02 02 02 02 02 02 02 02 02 02 02 02 02 02 03 03 02 03 02 02 03 02 02 02 02 02 02 02 02 08
08 02 00 02 02 02 02 02 03 02 02 02 02 02 02 02 02 03 03 00 02 02 02 02 02 02 02 03 02 02 03 02 05 02 02 02 02 00 02 08
08 02 03 02 02 00 02 02 03 02 00 00 02 02 02 02 02 03 02 03 05 02 02 05 02 02 02 02 03 02 02 02 03 02 02 05 02 03 02 08
08 02 05 03 02 02 02 02 02 02 02 02 02 02 02 02 02 02 03 03 03 02 02 03 02 02 02 02 02 02 02 02 05 02 02 02 02 02 03 08
08 02 02 02 02 02 02 02 02 07 07 07 07 07 07 07 07 07 07 07 07 07 07 07 07 07 07 07 07 07 07 07 07 07 07 07 07 07 07 08
08 00 00 02 02 02 02 02 02 02 02 02 00 02 02 02 05 02 02 02 02 03 02 02 02 02 02 03 02 02 02 03 02 02 02 02 02 02 02 08
08 03 00 02 02 02 02 02 02 02 02 02 03 03 02 02 03 02 02 02 02 02 02 02 02 03 02 02 02 02 02 02 03 02 03 00 02 02 09 08
08 02 03 02 02 03 02 02 02 02 02 02 02 02 03 02 02 02 02 02 03 02 00 00 02 02 02 02 05 02 02 02 03 02 03 03 02 02 02 08
08 02 02 02 02 03 05 02 02 00 02 02 02 02 02 02 02 02 03 02 02 02 02 02 02 03 02 03 05 02 02 02 02 02 02 03 02 02 02 08
08 02 02 02 00 02 02 00 02 03 02 02 03 02 03 03 02 02 02 02 02 02 02 02 02 03 02 03 05 02 02 02 02 02 02 03 02 02 03 08
08 02 05 02 02 02 02 03 02 02 02 02 02 00 02 02 02 02 02 02 02 02 02 00 02 03 02 02 03 02 02 02 02 03 02 02 02 03 02 08
08 08 08 08 08 08 08 08 08 08 08 08 08 08 08 08 08 08 08 08 08 08 08 08 08 08 08 08 08 08 08 08 08 08 08 08 08 08 08 08

20 09
08 08 08 08 08 08 08 08 08 08 08 08 08 08 08 08 08 08 08 08 08 08 08 08 08 08 08 08 08 08 08 08 08 08 08 08 08 08 08 08
08 01 07 00 11 11 11 11 07 07 07 07 07 07 07 07 07 07 07 07 07 00 00 00 00 00 00 00 03 00 00 00 00 00 00 00 00 00 00 08
08 00 07 00 07 07 07 07 07 00 00 00 00 00 00 00 00 00 00 11 07 00 07 07 07 07 07 07 07 00 07 07 07 07 07 07 07 07 00 08
08 00 07 00 07 12 11 12 07 00 07 07 07 00 07 07 07 07 07 05 07 00 07 05 05 05 05 05 07 00 07 00 00 00 00 00 00 07 00 08
08 00 07 00 07 11 07 11 07 00 07 05 07 00 07 05 00 00 00 11 07 00 07 07 07 07 07 05 07 00 07 00 07 07 07 07 00 07 00 08
08 00 00 00 07 12 07 12 07 00 11 05 07 00 07 11 07 07 07 07 07 00 07 11 12 12 11 11 07 00 07 00 07 00 00 07 00 07 00 08
08 00 07 00 07 12 07 12 07 07 07 07 07 00 07 05 00 00 00 12 07 00 07 11 07 07 07 12 07 00 07 00 07 00 00 07 00 07 00 08
08 00 07 00 07 02 07 02 07 00 00 00 00 00 07 07 07 07 07 12 07 00 07 12 07 11 07 12 07 00 07 00 07 09 00 07 00 07 00 08
08 11 07 00 07 00 07 00 07 00 07 07 07 00 07 00 00 00 00 12 07 00 07 12 07 11 07 11 07 00 07 00 07 07 00 07 00 07 00 08
08 05 07 00 07 00 07 00 07 00 07 05 07 00 07 00 07 07 07 07 07 00 07 11 07 12 12 11 07 00 07 00 00 00 00 07 00 07 00 08
08 11 07 00 07 00 07 00 07 00 07 05 07 00 07 00 07 00 00 00 00 00 07 11 07 07 07 07 07 00 07 07 07 07 07 07 00 07 00 08
08 07 07 00 07 00 07 00 07 00 11 05 07 00 07 00 07 07 07 00 07 00 07 12 12 11 11 12 07 00 00 00 00 00 00 00 00 07 00 08
08 00 00 00 07 00 07 00 07 00 07 07 07 00 07 00 07 05 00 00 07 00 07 07 07 07 07 12 07 00 07 07 07 07 07 07 07 07 00 08
08 00 07 07 07 00 07 00 07 00 07 11 12 11 07 00 07 05 07 07 07 00 07 05 05 05 05 05 07 00 00 00 00 00 00 00 00 00 00 08
08 00 07 00 00 11 07 00 07 00 07 07 07 07 07 00 07 05 00 11 07 00 07 07 07 07 07 07 07 00 07 07 07 07 07 07 07 07 07 08
08 00 07 00 07 07 07 00 07 00 00 00 00 00 07 00 07 07 07 11 07 00 07 11 05 11 07 00 07 00 07 05 05 05 12 12 12 11 11 08
08 00 07 00 00 00 00 00 07 00 07 07 07 00 07 00 07 05 00 11 07 00 07 05 07 05 07 00 07 00 07 11 07 07 07 07 07 07 11 08
08 00 07 05 07 00 07 05 07 00 07 00 07 00 07 00 07 05 07 07 07 00 07 11 07 11 07 00 07 00 07 11 07 12 11 11 05 07 05 08
08 00 07 05 07 00 07 05 07 00 07 00 00 00 07 00 07 05 00 00 07 00 07 05 07 05 07 00 07 00 07 11 12 12 12 05 05 07 05 08
08 00 07 07 07 00 07 07 07 07 07 00 07 07 07 00 07 07 07 00 07 07 07 02 07 07 07 00 07 00 07 07 07 07 07 07 07 07 05 08
08 00 00 00 00 00 00 00 00 00 00 00 00 00 07 00 00 00 00 00 00 00 00 00 00 00 00 00 07 14 05 05 05 11 11 11 12 12 12 08
08 08 08 08 08 08 08 08 08 08 08 08 08 08 08 08 08 08 08 08 08 08 08 08 08 08 08 08 08 08 08 08 08 08 08 08 08 08 08 08