2

40 22

150 18 18
08 08 08 08 08 08 08 08 08 08 08 08 08 08 08 08 08 08 08 08 08 08 08 08 08 08 08 08 08 08 08 08 08 08 08 08 08 08 08 08
08 01 02 16 02 00 00 00 00 00 02 00 00 00 02 00 00 00 00 00 00 00 00 00 00 00 00 00 00 00 00 00 00 00 00 00 00 00 00 08
08 05 08 00 02 00 02 00 02 00 02 00 02 00 02 00 00 00 00 00 00 00 00 00 00 00 00 00 00 00 00 00 00 00 00 00 00 00 00 08
08 05 08 00 02 02 02 00 02 02 02 00 02 00 02 00 00 00 00 00 00 00 00 00 00 00 00 00 00 00 00 00 00 00 00 00 00 00 00 08
08 05 08 00 00 00 00 00 00 00 02 00 02 00 02 00 00 00 00 00 00 00 00 00 00 00 00 00 00 00 00 00 00 00 00 00 00 00 00 08
08 05 08 00 02 00 00 00 02 00 02 00 02 00 02 00 00 00 00 00 00 00 00 00 00 00 00 00 00 00 00 00 00 00 00 00 00 00 00 08
08 05 08 00 02 00 00 00 02 00 02 00 02 00 02 00 00 00 00 00 00 00 00 00 00 00 00 00 00 00 00 00 00 00 00 00 00 00 00 08
08 05 08 00 02 00 00 00 02 00 02 00 02 00 02 00 00 00 00 00 00 00 00 00 00 00 00 00 00 00 00 00 00 00 00 00 00 00 00 08
08 05 08 00 02 00 02 02 02 00 02 00 02 00 02 00 00 00 00 00 00 00 00 00 00 00 00 00 00 00 00 00 00 00 00 00 00 00 00 08
08 05 08 00 02 00 02 00 00 00 00 00 02 00 02 00 00 00 00 00 00 00 00 00 00 00 00 00 00 00 00 00 00 00 00 00 00 00 00 08
08 05 08 00 02 00 02 00 02 02 02 02 02 00 02 00 00 00 00 00 00 00 00 00 00 00 00 00 00 00 00 00 00 00 00 00 00 00 00 08
08 05 08 00 02 00 02 00 02 02 02 02 02 00 02 00 00 00 00 00 00 00 00 00 00 00 00 00 00 00 00 00 00 00 00 00 00 00 00 08
08 05 08 00 02 00 02 00 00 00 00 00 02 00 02 00 00 00 00 00 00 00 00 00 00 00 00 00 00 00 00 00 00 00 00 00 00 00 00 08
08 05 08 00 02 00 02 02 02 02 02 00 02 00 02 00 00 00 00 00 00 00 00 00 00 00 00 00 00 00 00 00 00 00 00 00 00 00 00 08
08 05 08 00 02 00 00 00 00 00 02 00 02 00 02 00 00 00 00 00 00 00 00 00 00 00 00 00 00 00 00 00 00 00 00 00 00 00 00 08
08 05 08 00 02 00 02 02 02 02 02 00 02 00 02 00 00 00 00 00 00 00 00 00 00 00 00 00 00 00 00 00 00 00 00 00 00 00 00 08
08 05 08 00 02 00 02 00 00 00 00 00 02 00 02 00 00 00 00 00 00 00 00 00 00 00 00 00 00 00 00 00 00 00 00 00 00 00 00 08
08 05 08 00 02 00 02 00 00 00 00 00 02 00 02 00 00 00 00 00 00 00 00 00 00 00 00 00 00 00 00 00 00 00 00 00 00 00 00 08
08 05 08 00 02 00 02 00 02 02 02 00 02 00 02 00 00 00 00 00 00 00 00 00 00 00 00 00 00 00 00 00 00 00 00 00 00 00 00 08
08 05 08 00 02 00 02 02 02 00 02 00 02 00 02 00 00 00 00 00 00 00 00 00 00 00 00 00 00 00 00 00 00 00 00 00 00 00 00 08
08 09 08 00 02 00 00 00 00 00 02 00 00 00 02 00 00 00 00 00 00 00 00 00 00 00 00 00 00 00 00 00 00 00 00 00 00 00 00 08
08 08 08 08 08 08 08 08 08 08 08 08 08 08 08 08 08 08 08 08 08 08 08 08 08 08 08 08 08 08 08 08 08 08 08 08 08 08 08 08

150 4 18
8 8 8 8 8 8 8 8 8 8 8 8 8 8 8 8 8 8 8 8 8 8 8 8 8 8 8 8 8 8 8 8 8 8 8 8 8 8 8 8
8 2 2 2 2 2 2 0 2 2 5 2 3 0 2 2 2 2 2 3 2 3 2 2 2 2 2 2 2 0 2 2 2 2 3 2 2 2 2 8
8 2 3 1 3 2 2 2 2 2 2 0 2 2 2 2 2 2 2 2 2 3 5 2 2 3 2 2 2 2 0 2 2 2 2 2 0 2 2 8
8 2 2 2 2 2 2 2 2 2 2 0 2 2 0 2 2 2 2 2 3 2 3 2 2 3 2 2 2 2 2 2 2 2 3 2 2 2 2 8
8 3 2 0 0 2 2 2 2 2 2 2 2 2 3 2 2 2 2 2 2 3 2 2 3 2 2 2 2 3 2 2 2 3 2 2 2 2 2 8
8 3 2 3 3 2 2 2 2 2 2 2 2 2 3 3 2 2 3 2 2 2 2 2 2 2 2 3 2 2 2 2 2 2 3 2 3 0 2 8
8 2 2 2 3 2 2 3 2 2 2 2 2 2 2 2 3 2 2 2 2 2 3 2 0 3 2 2 2 2 2 2 2 2 3 2 3 3 2 8
8 7 7 7 7 7 7 7 7 7 7 7 7 7 7 7 7 7 7 7 7 7 7 7 7 7 7 7 7 7 7 2 2 2 3 2 2 3 2 8
8 2 0 2 2 2 3 2 2 5 2 0 2 2 3 2 3 2 2 2 2 2 2 2 2 2 2 5 2 3 0 2 2 2 2 2 2 3 2 8
8 2 2 5 2 2 2 2 2 3 2 2 2 2 2 0 2 2 2 2 2 2 2 2 3 0 0 3 2 2 5 2 2 2 2 3 2 2 2 8
8 2 2 2 3 2 2 3 2 3 2 2 2 2 2 2 2 2 2 2 2 2 2 2 3 3 2 3 2 2 3 2 2 2 2 2 2 2 2 8
8 2 0 2 2 2 2 2 3 2 2 2 2 2 2 2 2 3 3 0 2 2 2 2 2 2 2 3 2 2 3 2 5 2 2 2 2 0 2 8
8 2 3 2 2 0 2 2 3 2 0 0 2 2 2 2 2 3 2 3 5 2 2 5 2 2 2 2 3 2 2 2 3 2 2 5 2 3 2 8
8 2 5 3 2 2 2 2 2 2 2 2 2 2 2 2 2 2 3 3 3 2 2 3 2 2 2 2 2 2 2 2 5 2 2 2 2 2 3 8
8 2 2 2 2 2 2 2 2 7 7 7 7 7 7 7 7 7 7 7 7 7 7 7 7 7 7 7 7 7 7 7 7 7 7 7 7 7 7 8
8 0 0 2 2 2 2 2 2 2 2 2 0 2 2 2 5 2 2 2 2 3 2 2 2 2 2 3 2 2 2 3 2 2 2 2 2 2 2 8
8 3 0 2 2 2 2 2 2 2 2 2 3 3 2 2 3 2 2 2 2 2 2 2 2 3 2 2 2 2 2 2 3 2 3 0 2 2 9 8
8 2 3 2 2 3 2 2 2 2 2 2 2 2 3 2 2 2 2 2 3 2 0 0 2 2 2 2 5 2 2 2 3 2 3 3 2 2 2 8
8 2 2 2 2 3 5 2 2 0 2 2 2 2 2 2 2 2 3 2 2 2 2 2 2 3 2 3 5 2 2 2 2 2 2 3 2 2 2 8
8 2 2 2 0 2 2 0 2 3 2 2 3 2 3 3 2 2 2 2 2 2 2 2 2 3 2 3 5 2 2 2 2 2 2 3 2 2 3 8
8 2 5 2 2 2 2 3 2 2 2 2 2 0 2 2 2 2 2 2 2 2 2 0 2 3 2 2 3 2 2 2 2 3 2 2 2 3 2 8
8 8 8 8 8 8 8 8 8 8 8 8 8 8 8 8 8 8 8 8 8 8 8 8 8 8 8 8 8 8 8 8 8 8 8 8 8 8 8 8

150 0 0
08 08 08 08 08 08 08 08 08 08 08 08 08 08 08 08 08 08 08 08 08 08 08 08 08 08 08 08 08 08 08 08 08 08 08 08 08 08 08 08
08 01 00 00 00 00 00 00 00 00 00 00 00 00 00 00 00 00 00 00 00 00 00 00 00 00 00 00 00 00 00 00 00 00 00 00 00 00 00 08
08 00 00 00 00 00 00 00 00 00 00 00 00 00 00 00 00 00 00 00 00 00 00 00 00 00 00 00 00 00 00 00 00 00 00 00 00 00 00 08
08 00 00 00 00 00 00 00 00 00 00 00 00 00 00 00 00 00 00 00 00 00 00 00 00 00 00 00 00 00 00 00 00 00 00 00 00 00 00 08
08 00 00 00 00 00 00 00 00 00 00 00 00 00 00 00 00 00 00 00 00 00 00 00 00 00 00 00 00 00 00 00 00 00 00 00 00 00 00 08
08 00 00 00 00 00 00 00 00 00 00 00 00 00 00 00 00 00 00 00 00 00 00 00 00 00 00 00 00 00 00 00 00 00 00 00 00 00 00 08
08 00 00 00 00 00 00 00 00 00 00 00 00 00 00 00 00 00 00 00 00 00 00 00 00 00 00 00 00 00 00 00 00 00 00 00 00 00 00 08
08 00 00 00 00 00 00 00 00 00 00 00 00 00 00 00 00 00 00 00 00 00 00 00 00 00 00 00 00 00 00 00 00 00 00 00 00 00 00 08
08 00 00 00 00 00 00 00 00 00 00 00 00 00 00 00 00 00 00 00 00 00 00 00 00 00 00 00 00 00 00 00 00 00 00 00 00 00 00 08
08 00 00 00 00 00 00 00 00 00 00 00 00 00 00 00 00 00 00 00 00 00 00 00 00 00 00 00 00 00 00 00 00 00 00 00 00 00 00 08
08 00 00 00 00 00 00 00 00 00 00 00 00 00 00 00 00 00 00 00 00 00 00 00 00 00 00 00 00 00 00 00 00 00 00 00 00 00 00 08
08 00 00 00 00 00 00 00 00 00 00 00 00 00 00 00 00 00 00 00 00 00 00 00 00 00 00 00 00 00 00 00 00 00 00 00 00 00 00 08
08 00 00 00 00 00 00 00 00 00 00 00 00 00 00 00 00 00 00 00 00 00 00 00 00 00 00 00 00 00 00 00 00 00 00 00 00 00 00 08
08 00 00 00 00 00 00 00 00 00 00 00 00 00 00 00 00 00 00 00 00 00 00 00 00 00 00 00 00 00 00 00 00 00 00 00 00 00 00 08
08 00 00 00 00 00 00 00 00 00 00 00 00 00 00 00 00 00 00 00 00 00 00 00 00 00 00 00 00 00 00 00 00 00 00 00 00 00 00 08
08 00 00 00 00 00 00 00 00 00 00 00 00 00 00 00 00 00 00 00 00 00 00 00 00 00 00 00 00 00 00 00 00 00 00 00 00 00 00 08
08 00 00 00 00 00 00 00 00 00 00 00 00 00 00 00 00 00 00 00 00 00 00 00 00 00 00 00 00 00 00 00 00 00 00 00 00 00 00 08
08 00 00 00 00 00 00 00 00 00 00 00 00 00 00 00 00 00 00 00 00 00 00 00 00 00 00 00 00 00 00 00 00 00 00 00 00 00 00 08
08 00 00 00 00 00 00 00 00 00 00 00 00 00 00 00 00 00 00 00 00 00 00 00 00 00 00 00 00 00 00 00 00 00 00 00 00 00 00 08
08 00 00 00 00 00 00 00 00 00 00 00 00 00 00 00 00 00 00 00 00 00 00 00 00 00 00 00 00 00 00 00 00 00 00 00 00 00 00 08
08 00 00 00 00 00 00 00 00 00 00 00 00 00 00 00 00 00 00 00 00 00 00 00 00 00 00 00 00 00 00 00 00 00 00 00 00 00 00 08
08 08 08 08 08 08 08 08 08 08 08 08 08 08 08 08 08 08 08 08 08 08 08 08 08 08 08 08 08 08 08 08 08 08 08 08 08 08 08 08